you	te
fig tree	higuera
Phillip	Felipe
pots	tinajuelas
water	agua
with	de
filled	hinchiéronlas
you	os
earthly	terrenas
how	cómo
decrease	menguar
increase	crecer
must	conviene
see	viereis
wonders	milagros
found	halló
heal;made well;well	sanado
happens	venga
well;healthy	sano
no	nothing
that	porque
mountain	monte
went	subió
filled;satisfied	saciados
gather	Recoged
lost	pierda
went	descendieron
came	hizo
but	mas
said	dijéronle
give	danos
there;therefore	y
who	quién
listen	oir
then	Pues
see	viereis
first;before	primero
for	que
said	decían
where	Dónde
is	está
he	aquél
sought	buscábanle
was	había
much	grande
murmuring	murmullo
leads	engaña
multitude	gentes
marveled	maravillábanse
how	Cómo
never	no
educated	aprendido
answered	respondiéronle
seed	Simiente
are	somos
bondage	servimos
never	jamás
bondservant	servo
remains;lives;stays	queda
forever	siempre
your	te
said	decir
your	los
said	decían
is	está
surround;came around	rodeáronle
said	dijéronle
how long	cuándo
plainly	abiertamente
answered	Respondióles
i	yo
are	sois
told	Dícenle
trying	procuraban
stone	apedrearte
there	allá
awake	despertarle
asleep	duerme
will	estará
recover;safe	salvo
loud	gran
counsel	consultaban
death	matarle
found	halló
donkey	asnillo
sat	sentó
it	se
written	escrito
name	nombre
when	que
garment	ropa
sat	sentar
are	sois
another	otros
life	alma
you	ti
put;lay	pondré
by	en
stumble	escandalicéis
peace	paz
have	tengáis
oppression	aflicción
cheer	confiad
overcome;defeated	vencido
therefore;however;nonetheless;yet	empero
went	salió
forth	delante
said	díjoles
to	en
fall;fell	cayeron
again	pues
Nazareth	Nazareno
criminal;evildoer	malhechor
bring	traigo
no	ningún
saying;speech	palabra
was	tuvo
then	Después
mother	madre
took;received;welcomed	recibió
legs	piernas
stooping	bajándose
his;own	suyos
turned	Volviéndose
showed	mostróles
side	costado
enjoy;glad	gozaron
saw	viendo
blew;breathed	sopló
receive	Tomad
holy	Santo
forgive	remitiereis
sin	pecados
forgiven	remitidos
retain	retuviereis
retained	retenidos
coming	Vamos
entered	subieron
that	aquella
caught	cogieron
got	descendieron
saw	vieron
fire	ascuas
